貸借対照表（Balance Sheets）の英語表記
資産（Assets）の英語表記
流動資産（Current assets）の英語表記
現金	Cash
当座預金	Checking accounts
普通預金	Savings accounts
通知預金	Notice account
定期預金	Time deposits
定期積金	Installment savings account
受取手形	Trade notes receivable
売掛金	Trade accounts receivable
貸倒引当金	Allowance for doubtful accounts
有価証券	Marketable securities
棚卸資産（Inventory）
商品	Merchandise
製品	Finished goods
仕掛品	Work in process
原材料	Raw materials
貯蔵品	Stock account
前渡金	Advance payments-trade
立替金	Advances paid
短期貸付金	Loans receivable
未収入金（未収金）	Accounts receivable-other
未収収益	Accrued income
前払費用	Prepaid Expenses
仮払金	Suspense payments
仮払消費税	Suspense paid consumption tax
流動資産（Non-current assets）の英語表記
有形固定資産（Property, plant and equipment）
建物	Buildings
建物附属設備	Buildings and accompanying facilities
構築物	Structures
機械装置	Machinery and equipment
車両運搬具	Vehicles
工具器具備品	Tools, furniture & fixtures
土地	Land
建設仮勘定	Construction in progress
減価償却累計額	Accumulated depreciation
無形固定資産（Intangible assets）
営業権	Goodwill
特許権	Patents
借地権	Leasehold rights
電話加入権	Telephone subscription right
ソフトウェア	Software
投資等（Investments and other assets）の英語表記
投資有価証券	Investment securities
出資金	Investments in capital
長期貸付金	Long-term loans receivable
破産債権等	Claims provable in rehabilitation and other
差入保証金	Guarantee deposits
長期前払金	Long-term prepaid expenses
保険積立金	Insurance funds
繰越資産（Deferred assets）
創立費	Organization costs
開業費	Start-up costs
開発費	Depelopment expense
試験研究費	Experiment and research expenses
新株発行費	Stock issuance cost
社債発行費	Bond issuance cost
社債発行差金	Bond issuance discount
事業主貸	Withdrawals by owner
負債（Liabilities）の英語表記
流動負債（Current liabilities）の英語表記
支払手形	Notes
買掛金	Accounts payable
前受金	Advance received
短期借入金	Short-term loans payable and long-term debt with current maturities
未払金	Accounts payable – other
未払費用	Accrued expenses
預り金	Withholdings
前受収益	Deferred revenues
仮受消費税	Suspense received Accrued consumption tax
未払消費税	Comsumption tax payable
未払法人税等	Income taxes payable
引当金（Provision）の英語表記
賞与引当金	Allowance for employees’ bonuses
退職給付引当金	Employees’ pension and retirement benefits
固定負債（Not current liabilities）の英語表記
社債	Bonds
長期借入金	Long-term debt
事業主借	Investments by owner
純資産（Net assets）の英語表記
資本金	Capital stock
資本準備金	Capital reserve
その他資本余剰金	Capital surplus
利益準備金	Legal reserve of retained earnings
任意積立金	Voluntary retained earnings
その他利益剰余金	Retained earnings
繰越利益剰余金	Retained earnings brought forward
元入金	Capital
損益計算書（Profit and loss statement）の英語表記
営業損益（Operating profit or loss）の英語表記
売上原価関連（Cost of salesx）の英語表記
売上	Sales
仕入	Purchases
販売費及び一般管理費（Selling, general and administrative expensesx）の英語表記
役員報酬	Directors’ compensations
給料	Salaries expense
雑給	Other salaries
賞与	Seasonal bonuses
退職金	Employee retirement allowance
旅費交通費	Traveling expense
広告宣伝費	Advertising expense
交際費	Entertainment expense
福利厚生費	Welfare expenses
法定福利費	Payroll taxes expense
荷造運送費	Packing and delivery expenses
通信費	Communication expenses
会議費	Conference expenses
水道光熱費	Utilities expense
消耗品費	upplies expenses
新聞図書費	Library expense
租税公課	Taxes and dues
地代家賃	Rents
支払手数料	Commission fee
寄付金	Donations expense
修繕費	Repairs expense
支払保険料	Insurance expenses
賃借料	Rent expenses
減価償却費	Depreciation expense
諸会費	Membership fee
雑費	Miscellaneous expenses
営業外収益（Non-operating income）の英語表記
受取利息	Interest income
支払利息	Interest expense
受取配当金	Dividend income
手形売却損	Loss on sales of notes payable
有価証券売却益	Gain on sale of securities
有価証券売却損	Loss on sale of securities
有価証券評価損	Loss on valuation of investment securities
為替差益	Net foreign currency translation gain
為替差損	Foreign exchange losses
雑収入	Miscellaneous income
雑損失	Miscellaneous loss
受取賃貸料	Rent income
特別損益・税金等（Extraordinary income, taxes, etc）の英語表記
償却債権取立益	Gain on bad debts recovered
固定資産売却益	Gain on sale of property, plant and equipment and intangible assets
固定資産売却損	Loss on sale of property, plant and equipment and intangible assets
固定資産除却損L	oss on disposal of property, plant and equipment and intangible assets
前期損益修正益	Gain on prior period adjustment
前期損益修正損	Loss on prior period adjustment
税金等（Tax）の英語表記
法人税、住民税及び事業税	Income taxes-current
